super encryption
15
20
GGGGGGGGGGGGGGGGGGGG
GGGGGGGGGGGGGGGGGGGG
GGGGGGGGGGGGGGGGGGGG
GGGGGGGGGGGGGGGGGGGG
GGGGGGGGGGGGGGGGGGGG
GGGGGGGGGGGGGGGGGGGG
GGGGGGGGGGGGGGGGGGGG
GGGGGGGGGGGGGGGGGGGG
GGGGGGGGGGGGGGGGGGGG
GGGGGGGGGGGGGGGGGGGG
GRGGGRRRRRRRRRRRRRRR
GRRGGRRRRRRRRRRRRRRR
GGGRRRRRRRRRRRRRRRRR
GGGGGRRRRRRRRRRRRRRR
GGGGGGGGGGGGGGGGGGGG